  +----------+
  |..........|
  |..+-+.....|
  |..|.......|
  |..+-+.....|
  |..........|
  +----------+
